2 2 2 2 2 2 2 2 2 2 2 2 2 2 2 2 2 2 2 2
0 0 0 0 0 0 0 0 0 0 0 0 0 0 0 0 0 0 0 0
0 0 0 0 0 0 0 0 0 0 0 0 0 0 0 0 0 0 0 0
0 0 0 0 0 0 0 2 2 2 2 0 0 0 0 0 2 0 2 0
0 0 0 0 0 0 0 2 0 0 0 0 0 0 0 0 2 6 2 0
0 0 0 0 0 0 0 2 0 2 2 0 0 0 0 0 2 0 2  0
1 0 0 0 0 0 0 2 0 3 2 0 0 0 0 0 0 0 0 0
0 0 0 2 0 0 0 2 0 0 2 0 0 0 0 0 0 0 0 0
0 0 0 2 4 0 0 2 2 2 2 0 0 0 2 0 0 0 0 0
0 0 0 0 0 2 0 0 0 0 0 0 0 0 2 5 2 0 0 0
0 0 0 0 0 0 0 0 0 0 0 0 0 0 0 0 0 0 0 0
